1111111111111111111111111111111
10000000000000011110000000000E1
1000000100000001111001101100111
1011110101111101111011111110111
1011110101111101111001111100101
1011110001111101111000111000101
1000001111000000000010010011101
1111100000011101000000000011101
1000001111000000001100001011101
1111101111011101111111100000001
1000001111011101111111101101111
1011101111011100001100001101111
1P11100000000000000001111001111
1111111111111111111111111111111