1111111111111111111111111111111
1C000000000000C11110000000000E1
10000001000000011110011C1100111
1011110101111101111011111110111
10111101011111011110011111001C1
1011110C01111101111000111000101
1000001111000000000010010011101
11111000000111010000C0000011101
1000001111000000001100001011101
1111101111011101111111100000001
1000001111011101111111101101111
10111011110111000C1100001101111
10111C0000000000000001111C01111
1111111111111111111111111111111