1111111111111111111111111111111
1000000000000001111000000000101
1000000100000001111001101100111
1011110101111101111011111110111
1011110101111101111001111100101
1011110001111101111000111000101
1000001111000000000010010011101
1111100000011101000000000011101
1000001111000000001100001011101
1111101111011101111111100000001
1C10001111011101111111101101111
1E11101111011100001100001101111
1P11100000000000000001111001111
1111111111111111111111111111111